WWWWWWWWWWWWWWWWWWWWWWWWWWWWWWWWWWWWWWWWWWWWWWWWWWWWWWWWWWWWWWWWWWWW
WBBBBBBBBBBBBBBBBBBBBBBBBBBBBBBBBBBBBBBBBBBBBBBBBBBBBBBBBBBBBBBBBBBW	
WBBBBBBBBBBBBBBBBBBBBBBBBBBBBBBBBBBBBBBBBBBBBBBBBBBBBBBBBBBBBBBBBBBW
WBBBBBLLLLLLLLLLLLLLLBBBBBBBBBBBBLLLLLLLLLLLBBBBBBBBBBBLLLLLLLLLLLLW
WBBBBBDDDDDDDDDDDDDDDBPBBBBBBBBBBDDDDDDDDDDDBBBBBBBBBBBDDDDDDDDDDDDW
WBBBLLLLLLLLLLLLLLLLLLLBBBBBBBBLLLLLLLLLLLLLLLBBBBBBBLLLLLLLLLLLLLLW
WBSBDDDDDDDDDDDDDDDDDDDBBBBBBBBDDDDDDDDDDDDDDDBBBBBBBDDDDDDDDDDDEDDW
WLLLLLLLLLLLLLLLLLLLLLLLLLLLLLLLLLLLLLLLLLLLLLLLLLLLLLLLLLLLLLLLLLLW
WBBBBBBBBBBBBBBBBBBBBBBBBBBBBBBBBBBBBBBBBBBBBBBBBBBBBBBBBBBBBBBBBBBW
WWWWWWWWWWWWWWWWWWWWWWWWWWWWWWWWWWWWWWWWWWWWWWWWWWWWWWWWWWWWWWWWWWWW